#################
X    ###     ####
#@@@ @@@ @@@ @@@#
#@@@ @@@ @@@ @@@#
#@@@ @@@ @@@ @@@#
#@@@ @@@ @@@ @@@#
#@@@ @@@ @@@ @@@#
#@@@ @@@ @@@ @@@#
#@@@ @@@ @@@ @@@#
#@@@ @@@ @@@ @@@#
#@@@ @@@ @@@ @@@#
#@@@ @@@ @@@ @@@#
#@@@     @@@    $
#@#@@@@@@@@@@@@@#
#################