#############
X   @@@@@@@##
#@@ @@@@@@@##
#@  @@@@@@@##
#@ @@@@@@  $#
#  @@@@@@ @@#
# @@   @@   #
#    @  @@@ #
#@@@@@@ @   #
#@@@@@@   @@#
#############