#######
X@  @@@#
#@@ @@@#
#@@  @@#
#@@@   $
########
